Flash Cards			NH Cities by County

Acworth			Sullivan
Albany			Carroll
Alexandria		Grafton
Allenstown		Merrimack
Alstead			Cheshire
Alton			Belknap
Amherst			Hillsborough
Andover			Merrimack
Antrim			Hillsborough
Ashland			Grafton
Atkinson		Rockingham
Auburn			Rockingham
Barnstead		Belknap
Barrington		Strafford
Bartlett		Carroll
Bath			Grafton
Bedford			Hillsborough
Belmont			Belknap
Bennington		Hillsborough
Benton			Grafton
Berlin			Coös
Bethlehem		Grafton
Boscawen		Merrimack
Bow				Merrimack
Bradford		Merrimack
Brentwood	Rockingham
Bridgewater	Grafton
Bristol	Grafton
Brookfield	Carroll
Brookline	Hillsborough
Campton	Grafton
Canaan	Grafton
Candia	Rockingham
Canterbury	Merrimack
Carroll	Coös
Center Harbor	Belknap
Charlestown	Sullivan
Chatham	Carroll
Chester	Rockingham
Chesterfield	Cheshire
Chichester	Merrimack
Claremont	Sullivan
Clarksville	Coös
Colebrook	Coös
Columbia	Coös
Concord	Merrimack
Conway	Carroll
Cornish	Sullivan
Croydon	Sullivan
Dalton	Coös
Danbury	Merrimack
Danville	Rockingham
Deerfield	Rockingham
Deering	Hillsborough
Derry	Rockingham
Dorchester	Grafton
Dover	Strafford
Dublin	Cheshire
Dummer	Coös
Dunbarton	Merrimack
Durham	Strafford
East Kingston	Rockingham
Easton	Grafton
Eaton	Carroll
Effingham	Carroll
Ellsworth	Grafton
Enfield	Grafton
Epping	Rockingham
Epsom	Merrimack
Errol	Coös
Exeter	Rockingham
Farmington	Strafford
Fitzwilliam	Cheshire
Francestown	Hillsborough
Franconia	Grafton
Franklin	Merrimack
Freedom	Carroll
Fremont	Rockingham
Gilford	Belknap
Gilmanton	Belknap
Gilsum	Cheshire
Goffstown	Hillsborough
Gorham	Coös
Goshen	Sullivan
Grafton	Grafton
Grantham	Sullivan
Greenfield	Hillsborough
Greenland	Rockingham
Greenville	Hillsborough
Groton	Grafton
Hampstead	Rockingham
Hampton	Rockingham
Hampton Falls	Rockingham
Hancock	Hillsborough
Hanover	Grafton
Harrisville	Cheshire
Hart's Location	Carroll
Haverhill	Grafton
Hebron	Grafton
Henniker	Merrimack
Hill	Merrimack
Hillsborough	Hillsborough
Hinsdale	Cheshire
Holderness	Grafton
Hollis	Hillsborough
Hooksett	Merrimack
Hopkinton	Merrimack
Hudson	Hillsborough
Jackson	Carroll
Jaffrey	Cheshire
Jefferson	Coös
Keene	Cheshire
Kensington	Rockingham
Kingston	Rockingham
Laconia	Belknap
Lancaster	Coös
Landaff	Grafton
Langdon	Sullivan
Lebanon	Grafton
Lee	Strafford
Lempster	Sullivan
Lincoln	Grafton
Lisbon	Grafton
Litchfield	Hillsborough
Littleton	Grafton
Londonderry	Rockingham
Loudon	Merrimack
Lyman	Grafton
Lyme	Grafton
Lyndeborough	Hillsborough
Madbury	Strafford
Madison	Carroll
Manchester	Hillsborough
Marlborough	Cheshire
Marlow	Cheshire
Mason	Hillsborough
Meredith	Belknap
Merrimack	Hillsborough
Middleton	Strafford
Milan	Coös
Milford	Hillsborough
Milton	Strafford
Monroe	Grafton
Mont Vernon	Hillsborough
Moultonborough	Carroll
Nashua	Hillsborough
Nelson	Cheshire
New Boston	Hillsborough
New Castle	Rockingham
New Durham	Strafford
New Hampton		Belknap
New Ipswich		Hillsborough
New London	Merrimack
Newbury	Merrimack
Newfields	Rockingham
Newington	Rockingham
Newmarket	Rockingham
Newport	Sullivan
Newton	Rockingham
North Hampton	Rockingham
Northfield	Merrimack
Northumberland	Coös
Northwood	Rockingham
Nottingham	Rockingham
Orange	Grafton
Orford	Grafton
Ossipee	Carroll
Pelham	Hillsborough
Pembroke	Merrimack
Peterborough	Hillsborough
Piermont	Grafton
Pittsburg	Coös
Pittsfield	Merrimack
Plainfield	Sullivan
Plaistow	Rockingham
Plymouth	Grafton
Portsmouth	Rockingham
Randolph	Coös
Raymond	Rockingham
Richmond	Cheshire
Rindge	Cheshire
Rochester	Strafford
Rollinsford	Strafford
Roxbury	Cheshire
Rumney	Grafton
Rye	Rockingham
Salem	Rockingham
Salisbury	Merrimack
Sanbornton	Belknap
Sandown	Rockingham
Sandwich	Carroll
Seabrook	Rockingham
Sharon	Hillsborough
Shelburne	Coös
Somersworth	Strafford
South Hampton	Rockingham
Springfield	Sullivan
Stark	Coös
Stewartstown	Coös
Stoddard	Cheshire
Strafford	Strafford
Stratford	Coös
Stratham	Rockingham
Sugar Hill	Grafton
Sullivan	Cheshire
Sunapee	Sullivan
Surry	Cheshire
Sutton	Merrimack
Swanzey	Cheshire
Tamworth	Carroll
Temple	Hillsborough
Thornton	Grafton
Tilton	Belknap
Troy	Cheshire
Tuftonboro	Carroll
Unity	Sullivan
Wakefield	Carroll
Walpole	Cheshire
Warner	Merrimack
Warren	Grafton
Washington	Sullivan
Waterville Valley	Grafton
Weare	Hillsborough
Webster	Merrimack
Wentworth	Grafton
Westmoreland	Cheshire
Whitefield	Coös
Wilmot	Merrimack
Wilton	Hillsborough
Winchester	Cheshire
Windham	Rockingham
Windsor	Hillsborough
Wolfeboro	Carroll
Woodstock	Grafton

