Flash Card	A Few Elements and Symbols


Al	Aluminum
Am	Americium
Sb	Antimony
Ar	Argon
As	Arsenic
At	Astatine
Ba	Barium
Be	Beryllium
Bi	Bismuth
B	Boron
Br	Bromine
Cd	Cadmium
Ca	Calcium
Cf	Californium
C	Carbon
Ce	Cerium
Cs	Cesium
Cl	Chlorine
Cr	Chromium
Co	Cobalt
Cu	Copper
Cm	Curium
Es	Einsteinium
Fm	Fermium
F	Flourine
Ga	Gallium
Ge	Germanium
Au	Gold
H	Hydrogen
I	Iodine
Ir	Iridium
Fe	Iron
Kr	Krypton
La	Lanthanum
Pb	Lead
Li	Lithium
Mg	Magnesium
Mn	Manganese
Hg	Mercury
Mo	Molybdenum
Nd	Neodymium
Ne	Neon
Np	Neptunium
Ni	Nickel
N	Nitrogen
O	Oxygen
Pd	Palladium
P	Phosphorus
Pt	Platinum
Pu	Plutonium
Po	Polonium
K	Potassium
Ra	Radium
Rn	Radon
Se	Selenium
Si	Silicon
Ag	Silver
Na	Sodium
Sr	Strontium
S	Sulfur
Ta	Tantalum
Tc	Technetium
Tl	Thalium
Th	Thorium
Sn	Tin
Ti	Titanium
W	Tungsten
U	Uranium
V	Vanadium
Xi	Xenon
Zn	Zinc
Zr	Zirconium
